30 30 32 32
422222225422222222222222222225
8       68        8          6
8  1CCCC58        8          6
8  6    68        8          6
8  6    68        8          6
8  6    68        8          6
8  BCCCCBCCCC CCCCD          6
8                            6
8                            6
8                            6
8                            6
8                            6
8                            6 
8                            6
9CCCCCCCCCCCCCCCCCCCCCCCCCCCCA
