15 15 32 32
###############
#   #     #   #
#   #     #   #
#   #         #
## ##     #   #
#   #     #   #
#   ### #### ##
#             #
#             #
############ ##
#             #
#             #
#             #
#             #
###############
