30 30
42222222222577777777777777777
8          677777777777777777
8          677777777777777777
8          677777777777777777
8          677777777777777777
9CCC3 1CCCCA77777777777777777
77778 67777777777777777777777
4222D B2222577777777777777777
8          677777777777777777
8          677777777777777777
8          677777777777777777
8          677777777777777777
9CCCCCCCCCCA77777777777777777
77777777777777777777777777777
77777777777777777777777777777
77777777777777777777777777777
77777777777777777777777777777
77777777777777777777777777777
77777777777777777777777777777
77777777777777777777777777777
77777777777777777777777777777
77777777777777777777777777777
77777777777777777777777777777
77777777777777777777777777777
77777777777777777777777777777
77777777777777777777777777777
77777777777777777777777777777
77777777777777777777777777777
77777777777777777777777777777
1,1 10,5 1 3 4
1,9 10,12 1 3 4
